########## Legend ##########
# . : OPEN_SPOT
# B : BASE
# E : EGG_SHAPE
# Z : VERT_PIPE (formerly PIPE_VERT)
# F : FACE
# W : WEB
# R : TRIANGLE_RIGHT
# L : TRIANGLE_LEFT
# P : HORIZ_PIPE (formerly PIPE_HORIZ)
# S : SPIRAL
# M : METAL_BLOCK
# D : DOOR_SQUARE
# T : LAVA_TOP
# A : LAVA
# X : MARIO_TUBE_BLUE_LEFT
# Y : MARIO_TUBE_BLUE_RIGHT
# U : BUBBLE
# Q : SMALL_PIPE
# I : WHITE_PIPE_VERT
# Z : WHITE_PIPE_HORIZ
# N : WHITE_METAL
# C : WHITE_DOUBLE_PIPE
# Room Name: Corridor Number 4 - Part 5
# Powerups: Energy Tank (Middle of Room)
############################

UUUUUUUUUUUUUUUUUUUUUUUUUUUUUUUUCCCCNCCCCCNCCCCCUUUUUUUUUUUUUUUUUUUUUUUUUUUUUUUUUUUUUUUUUUUUUUUUUUUUUUUUUUUUUUU
UUUU......UU......UU......UU........N.....N.......UU......UU......UU......UU......UU......UU......UU.....UU..UU
UU..................................I.....I..................................................................UU
UU..................................I.....I..................................................................UU
UU..................................N.....N..................................................................UU
D........................................................F................................F...................D
D........................................................B................................B...................D
D........................................................B................................B...................D
UUUUUU...................................................B................................B................UUUU
UU.....................................F..........UUUU...B.........................UUUU...B..................UU
UU..........................UUUUSS....NBN.....SS............UUUU.............UUUU............UUUU............UU
UU..........UUUU....UUUUUU......WB..B.NBN.B...WB...........UUUU.....UUUUUU..................UUUU........UU...UU
UU....UUUUUUUU..........UU......BZB.B.IBI.B...BZB.......................UU.......U.................UU...UU...UU
UUTTTTTTTTTTTTTTTTTTTTTTTTTTTTTTZZTTTTTTTTTTTTZZTTTTTTTTTTTTTTTTTTTTTTTTTTTTTTTTTTTTTTTTTTTTTTTTTTTTTTTTTTTTTTU
UUAAAAAAAAAAAAAAAAAAAAAAAAAAAAAABBAAAAAAAAAAAABBAAAAAAAAAAAAAAAAAAAAAAAAAAAAAAAAAAAAAAAAAAAAAAAAAAAAAAAAAAAAAAU
